jTtXbw -> header-wrap

elKKmO -> header-menu

cTXEwn -> header-upper-layout

jHpnnN -> header-logo

iAA-dey -> header-status-wrap

dYJyXk -> header-project-btn

cjULHs -> header-user-btn

iAZePd -> header-user-btn-content

hvcyeH -> header-user-icon

bAnHGm -> user-icon

jrHuvh ->user-text

hcTLBP -> header-fixed

gLfCUw -> header-bottom-searchbar

iNyaoP -> header-bottom-category

ggsdvy -> header-bottom-list

cEUlkA -> hedare-list-icon

ivSnTG ->search-bar

iBbKFT -> search-input

cAaTcG -> search-btn
duzUwj -> main-layout
gkkAXC -> main-wrap
FSZyT -> main-top-section

exlPNM -> spotlight-section

bSfzwl -> current-hero-container

bzqZOc -> banner

eHPhMs -> swiper

cWmHBz -> swiper-slide

iHlulr -> swiper-link

mMpqQ -> select-slide

daFRot -> swiper-page-nation

REXou -> arrow-btn

kNVoaY -> shorcut-container
eaJEmj -> shorcut-btn

einLet -> thumbail

eNqHsG -> img-text

hEeTqE -> spotlight-bottom

exAEDh -> spotlight-bottom-title

gZfeBY -> spotlight-bottom-wrap

gwjQKh -> content-wrap

cuqaar -> content

ictsTD -> card

dRjXjA -> card-img

ljLQkd -> card-content

kVljqr -> card-like-btn

eCSLdu -> card-content-wrap

iZXyVj -> company-name

keUwyx -> creator-wrapper

KCDgH -> product-content

ejndhO -> percent

fsQueau -> date-wrap

iUoLSw -> date-content

elGXdv -> recommend

dOMiVm -> remain-date

iyUEiR -> side-bar-wrap

fZXZDs -> side-bar-title

enfTV -> side-bar-content

jiYbTB -> rank-prj-link

hOaOjP -> list-date

ghma-DT -> side-bar-card-wrap

jtUgVa -> side-bar-card-container


dqVzfo -> rank-num

kkATHs -> popular-prj-search


sbpix -> middle-wrap-section

gltdsQ -> middle-container

eMjvNB -> middle-content-title
ghSDFz -> middle-title-text

gORnfG -> title-icon
ehZPGX -> title-ad

fWvFpP -> middle-prj-list-wrap

imYpkR -> middle-prj-containner

hJCSvl -> middle-prj-wrap

hlRBMH -> middle-prj-list

lhBEmG -> slide-next-btn

fuBkMs -> circle-btn next-btn

igspVJ -> move-all-list